1111111111
1000000001
100P000E01
1111111111