1111111111
10C0000001
100PE00E01
1111111111