1111111111
10C000P001
100P000E01
1111111111