111111111111111111111111111111111111111111111111111111111111111111111111111111111111111111
10000000000000000000000000000000000