111111111111111111111111111111111111111111111111111111111111111111111111111111111111
100000000011111111111111111101111111110000000000111111111111111111111111111111111001
101111111111111111111111111100000000000000000000111111111100000000000000000000011101
100000000E00000000000000000100000000000000000000000000000100000000000000000000000001
101111111111110000001111111101111110000111111100011111100100011111111111111100111101
101111111111110000001111111101111110000111111100011111100100011111111111111100111101
100000000000000000000000000100000000000000000000000000000100000000000000000000000001
101111111111111111111111111100111111100111111111111111111100000000000000000000011101
100000000011111111111111111100000000000000C00000111111111111111111111111111111111001
101111111111111111111111111100111111111111111111111111111111111111111111111111111101
101111111111111111111111111100111111111111111111111111111111111111111111111111111101
100000000000000000000000000000000000000000000000000000000000000000000000000000000001
101111111111111111111111111110111111111111111111111111111111111111111111111111111101
100000000000000000000000000000000000000000000000000000000000000000000000000000000001
101111111111111111111111111100111111100111111111111111111111111111111111111111111101
100000000011111111111111111100000000000000000000111111111111111111111111111111111001
101111111111111111111111111100111111111111111111111111111111111111111111111111111101
101111111111111111111111111100111111111111111111111111111111111111111111111111111101
1000000000000000000000000000000000000000000000000000000000000000000P0000000000000001
111111111111111111111111111111111111111111111111111111111111111111111111111111111111