1111111111
10C0000001
100P000E01
1111111111