1111111111
1000000P01
100P0000E1
1111111111