1111111111
10C0000001
100P0000E1
1111111111