1111111111
10C0aa0001
100P000E01
1111111111